=====================================
Map id: 476a27e5-8c6a-4d6f-83c4-1654fd2d573b
An animal has been placed at (2,2)
 y\x  1 2 3 4 5 6 7 8 910
 11: ---------------------
 10: | | | | | | | | | |*|
  9: | | | | | | |*| | |*|
  8: | | | | | | | | | | |
  7: | | | | | | | | | | |
  6: |*| | |*| |*| | | | |
  5: | | | | | | | | | | |
  4: | | | | | | | | | | |
  3: |*| | | | |*| | | |*|
  2: | |^| | | | | | | | |
  1: | | | | | | | | | | |
  0: | | | |*| | | | | | |
 -1: ---------------------

==========================================================================
Map id: 476a27e5-8c6a-4d6f-83c4-1654fd2d573b
An animal has been placed at (5,6)
 y\x  1 2 3 4 5 6 7 8 910
 11: ---------------------
 10: | | | | | | | | | |*|
  9: | | | | | | |*| | |*|
  8: | | | | | | | | | | |
  7: | | | | | | | | | | |
  6: |*| | |*|^|*| | | | |
  5: | | | | | | | | | | |
  4: | | | | | | | | | | |
  3: |*| | | | |*| | | |*|
  2: | |^| | | | | | | | |
  1: | | | | | | | | | | |
  0: | | | |*| | | | | | |
 -1: ---------------------

==========================================================================
Map id: 476a27e5-8c6a-4d6f-83c4-1654fd2d573b
An animal has been placed at (2,3)
 y\x  1 2 3 4 5 6 7 8 910
 11: ---------------------
 10: | | | | | | | | | |*|
  9: | | | | | | |*| | |*|
  8: | | | | | | | | | | |
  7: | | | | | | | | | | |
  6: |*| | |*|^|*| | | | |
  5: | | | | | | | | | | |
  4: | | | | | | | | | | |
  3: |*|^| | | |*| | | |*|
  2: | | | | | | | | | | |
  1: | | | | | | | | | | |
  0: | | | |*| | | | | | |
 -1: ---------------------

==========================================================================
Map id: 476a27e5-8c6a-4d6f-83c4-1654fd2d573b
An animal has moved from (2,2) to (2,3)
 y\x  1 2 3 4 5 6 7 8 910
 11: ---------------------
 10: | | | | | | | | | |*|
  9: | | | | | | |*| | |*|
  8: | | | | | | | | | | |
  7: | | | | | | | | | | |
  6: |*| | |*|^|*| | | | |
  5: | | | | | | | | | | |
  4: | | | | | | | | | | |
  3: |*|^| | | |*| | | |*|
  2: | | | | | | | | | | |
  1: | | | | | | | | | | |
  0: | | | |*| | | | | | |
 -1: ---------------------

==========================================================================
Map id: 476a27e5-8c6a-4d6f-83c4-1654fd2d573b
An animal has been placed at (5,7)
 y\x  1 2 3 4 5 6 7 8 910
 11: ---------------------
 10: | | | | | | | | | |*|
  9: | | | | | | |*| | |*|
  8: | | | | | | | | | | |
  7: | | | | |^| | | | | |
  6: |*| | |*| |*| | | | |
  5: | | | | | | | | | | |
  4: | | | | | | | | | | |
  3: |*|^| | | |*| | | |*|
  2: | | | | | | | | | | |
  1: | | | | | | | | | | |
  0: | | | |*| | | | | | |
 -1: ---------------------

==========================================================================
Map id: 476a27e5-8c6a-4d6f-83c4-1654fd2d573b
An animal has moved from (5,6) to (5,7)
 y\x  1 2 3 4 5 6 7 8 910
 11: ---------------------
 10: | | | | | | | | | |*|
  9: | | | | | | |*| | |*|
  8: | | | | | | | | | | |
  7: | | | | |^| | | | | |
  6: |*| | |*| |*| | | | |
  5: | | | | | | | | | | |
  4: | | | | | | | | | | |
  3: |*|^| | | |*| | | |*|
  2: | | | | | | | | | | |
  1: | | | | | | | | | | |
  0: | | | |*| | | | | | |
 -1: ---------------------

==========================================================================
Map id: 476a27e5-8c6a-4d6f-83c4-1654fd2d573b
An animal has been placed at (2,4)
 y\x  1 2 3 4 5 6 7 8 910
 11: ---------------------
 10: | | | | | | | | | |*|
  9: | | | | | | |*| | |*|
  8: | | | | | | | | | | |
  7: | | | | |^| | | | | |
  6: |*| | |*| |*| | | | |
  5: | | | | | | | | | | |
  4: | |^| | | | | | | | |
  3: |*| | | | |*| | | |*|
  2: | | | | | | | | | | |
  1: | | | | | | | | | | |
  0: | | | |*| | | | | | |
 -1: ---------------------

==========================================================================
Map id: 476a27e5-8c6a-4d6f-83c4-1654fd2d573b
An animal has moved from (2,3) to (2,4)
 y\x  1 2 3 4 5 6 7 8 910
 11: ---------------------
 10: | | | | | | | | | |*|
  9: | | | | | | |*| | |*|
  8: | | | | | | | | | | |
  7: | | | | |^| | | | | |
  6: |*| | |*| |*| | | | |
  5: | | | | | | | | | | |
  4: | |^| | | | | | | | |
  3: |*| | | | |*| | | |*|
  2: | | | | | | | | | | |
  1: | | | | | | | | | | |
  0: | | | |*| | | | | | |
 -1: ---------------------

==========================================================================
Map id: 476a27e5-8c6a-4d6f-83c4-1654fd2d573b
An animal has been placed at (5,8)
 y\x  1 2 3 4 5 6 7 8 910
 11: ---------------------
 10: | | | | | | | | | |*|
  9: | | | | | | |*| | |*|
  8: | | | | |^| | | | | |
  7: | | | | | | | | | | |
  6: |*| | |*| |*| | | | |
  5: | | | | | | | | | | |
  4: | |^| | | | | | | | |
  3: |*| | | | |*| | | |*|
  2: | | | | | | | | | | |
  1: | | | | | | | | | | |
  0: | | | |*| | | | | | |
 -1: ---------------------

==========================================================================
Map id: 476a27e5-8c6a-4d6f-83c4-1654fd2d573b
An animal has moved from (5,7) to (5,8)
 y\x  1 2 3 4 5 6 7 8 910
 11: ---------------------
 10: | | | | | | | | | |*|
  9: | | | | | | |*| | |*|
  8: | | | | |^| | | | | |
  7: | | | | | | | | | | |
  6: |*| | |*| |*| | | | |
  5: | | | | | | | | | | |
  4: | |^| | | | | | | | |
  3: |*| | | | |*| | | |*|
  2: | | | | | | | | | | |
  1: | | | | | | | | | | |
  0: | | | |*| | | | | | |
 -1: ---------------------

==========================================================================
Map id: 476a27e5-8c6a-4d6f-83c4-1654fd2d573b
An animal has changed direction from Północ to Wschód
 y\x  1 2 3 4 5 6 7 8 910
 11: ---------------------
 10: | | | | | | | | | |*|
  9: | | | | | | |*| | |*|
  8: | | | | |^| | | | | |
  7: | | | | | | | | | | |
  6: |*| | |*| |*| | | | |
  5: | | | | | | | | | | |
  4: | |>| | | | | | | | |
  3: |*| | | | |*| | | |*|
  2: | | | | | | | | | | |
  1: | | | | | | | | | | |
  0: | | | |*| | | | | | |
 -1: ---------------------

==========================================================================
Map id: 476a27e5-8c6a-4d6f-83c4-1654fd2d573b
An animal has been placed at (5,9)
 y\x  1 2 3 4 5 6 7 8 910
 11: ---------------------
 10: | | | | | | | | | |*|
  9: | | | | |^| |*| | |*|
  8: | | | | | | | | | | |
  7: | | | | | | | | | | |
  6: |*| | |*| |*| | | | |
  5: | | | | | | | | | | |
  4: | |>| | | | | | | | |
  3: |*| | | | |*| | | |*|
  2: | | | | | | | | | | |
  1: | | | | | | | | | | |
  0: | | | |*| | | | | | |
 -1: ---------------------

==========================================================================
Map id: 476a27e5-8c6a-4d6f-83c4-1654fd2d573b
An animal has moved from (5,8) to (5,9)
 y\x  1 2 3 4 5 6 7 8 910
 11: ---------------------
 10: | | | | | | | | | |*|
  9: | | | | |^| |*| | |*|
  8: | | | | | | | | | | |
  7: | | | | | | | | | | |
  6: |*| | |*| |*| | | | |
  5: | | | | | | | | | | |
  4: | |>| | | | | | | | |
  3: |*| | | | |*| | | |*|
  2: | | | | | | | | | | |
  1: | | | | | | | | | | |
  0: | | | |*| | | | | | |
 -1: ---------------------

==========================================================================
Map id: 476a27e5-8c6a-4d6f-83c4-1654fd2d573b
An animal has been placed at (3,4)
 y\x  1 2 3 4 5 6 7 8 910
 11: ---------------------
 10: | | | | | | | | | |*|
  9: | | | | |^| |*| | |*|
  8: | | | | | | | | | | |
  7: | | | | | | | | | | |
  6: |*| | |*| |*| | | | |
  5: | | | | | | | | | | |
  4: | | |>| | | | | | | |
  3: |*| | | | |*| | | |*|
  2: | | | | | | | | | | |
  1: | | | | | | | | | | |
  0: | | | |*| | | | | | |
 -1: ---------------------

==========================================================================
Map id: 476a27e5-8c6a-4d6f-83c4-1654fd2d573b
An animal has moved from (2,4) to (3,4)
 y\x  1 2 3 4 5 6 7 8 910
 11: ---------------------
 10: | | | | | | | | | |*|
  9: | | | | |^| |*| | |*|
  8: | | | | | | | | | | |
  7: | | | | | | | | | | |
  6: |*| | |*| |*| | | | |
  5: | | | | | | | | | | |
  4: | | |>| | | | | | | |
  3: |*| | | | |*| | | |*|
  2: | | | | | | | | | | |
  1: | | | | | | | | | | |
  0: | | | |*| | | | | | |
 -1: ---------------------

==========================================================================
Map id: 476a27e5-8c6a-4d6f-83c4-1654fd2d573b
An animal has been placed at (5,10)
 y\x  1 2 3 4 5 6 7 8 910
 11: ---------------------
 10: | | | | |^| | | | |*|
  9: | | | | | | |*| | |*|
  8: | | | | | | | | | | |
  7: | | | | | | | | | | |
  6: |*| | |*| |*| | | | |
  5: | | | | | | | | | | |
  4: | | |>| | | | | | | |
  3: |*| | | | |*| | | |*|
  2: | | | | | | | | | | |
  1: | | | | | | | | | | |
  0: | | | |*| | | | | | |
 -1: ---------------------

==========================================================================
Map id: 476a27e5-8c6a-4d6f-83c4-1654fd2d573b
An animal has moved from (5,9) to (5,10)
 y\x  1 2 3 4 5 6 7 8 910
 11: ---------------------
 10: | | | | |^| | | | |*|
  9: | | | | | | |*| | |*|
  8: | | | | | | | | | | |
  7: | | | | | | | | | | |
  6: |*| | |*| |*| | | | |
  5: | | | | | | | | | | |
  4: | | |>| | | | | | | |
  3: |*| | | | |*| | | |*|
  2: | | | | | | | | | | |
  1: | | | | | | | | | | |
  0: | | | |*| | | | | | |
 -1: ---------------------

=====================================