=====================================
Map id: 5e810457-9460-41e5-a083-e1a8b464526b
An animal has been placed at (2,2)
 y\x  0 1 2 3 4 5 6 7 8 910
 11: -----------------------
 10: |*| | | | | | | | | | |
  9: | | | | | | | | | | | |
  8: | | | | | | | | | | |*|
  7: | | | | | | | | | | | |
  6: | | | | | | | | | | | |
  5: | | | | | | | | | | | |
  4: | | | | | |*| | | | | |
  3: | | | |*| | | | | | | |
  2: | | |^| | | | | | | |*|
  1: -----------------------

==========================================================================
Map id: 5e810457-9460-41e5-a083-e1a8b464526b
An animal has been placed at (5,6)
 y\x  0 1 2 3 4 5 6 7 8 910
 11: -----------------------
 10: |*| | | | | | | | | | |
  9: | | | | | | | | | | | |
  8: | | | | | | | | | | |*|
  7: | | | | | | | | | | | |
  6: | | | | | |^| | | | | |
  5: | | | | | | | | | | | |
  4: | | | | | |*| | | | | |
  3: | | | |*| | | | | | | |
  2: | | |^| | | | | | | |*|
  1: -----------------------

==========================================================================
Map id: 5e810457-9460-41e5-a083-e1a8b464526b
An animal has been placed at (2,3)
 y\x  0 1 2 3 4 5 6 7 8 910
 11: -----------------------
 10: |*| | | | | | | | | | |
  9: | | | | | | | | | | | |
  8: | | | | | | | | | | |*|
  7: | | | | | | | | | | | |
  6: | | | | | |^| | | | | |
  5: | | | | | | | | | | | |
  4: | | | | | |*| | | | | |
  3: | | |^|*| | | | | | | |
  2: | | | | | | | | | | |*|
  1: -----------------------

==========================================================================
Map id: 5e810457-9460-41e5-a083-e1a8b464526b
An animal has moved from (2,2) to (2,3)
 y\x  0 1 2 3 4 5 6 7 8 910
 11: -----------------------
 10: |*| | | | | | | | | | |
  9: | | | | | | | | | | | |
  8: | | | | | | | | | | |*|
  7: | | | | | | | | | | | |
  6: | | | | | |^| | | | | |
  5: | | | | | | | | | | | |
  4: | | | | | |*| | | | | |
  3: | | |^|*| | | | | | | |
  2: | | | | | | | | | | |*|
  1: -----------------------

==========================================================================
Map id: 5e810457-9460-41e5-a083-e1a8b464526b
An animal has been placed at (5,7)
 y\x  0 1 2 3 4 5 6 7 8 910
 11: -----------------------
 10: |*| | | | | | | | | | |
  9: | | | | | | | | | | | |
  8: | | | | | | | | | | |*|
  7: | | | | | |^| | | | | |
  6: | | | | | | | | | | | |
  5: | | | | | | | | | | | |
  4: | | | | | |*| | | | | |
  3: | | |^|*| | | | | | | |
  2: | | | | | | | | | | |*|
  1: -----------------------

==========================================================================
Map id: 5e810457-9460-41e5-a083-e1a8b464526b
An animal has moved from (5,6) to (5,7)
 y\x  0 1 2 3 4 5 6 7 8 910
 11: -----------------------
 10: |*| | | | | | | | | | |
  9: | | | | | | | | | | | |
  8: | | | | | | | | | | |*|
  7: | | | | | |^| | | | | |
  6: | | | | | | | | | | | |
  5: | | | | | | | | | | | |
  4: | | | | | |*| | | | | |
  3: | | |^|*| | | | | | | |
  2: | | | | | | | | | | |*|
  1: -----------------------

==========================================================================
Map id: 5e810457-9460-41e5-a083-e1a8b464526b
An animal has been placed at (2,4)
 y\x  0 1 2 3 4 5 6 7 8 910
 11: -----------------------
 10: |*| | | | | | | | | | |
  9: | | | | | | | | | | | |
  8: | | | | | | | | | | |*|
  7: | | | | | |^| | | | | |
  6: | | | | | | | | | | | |
  5: | | | | | | | | | | | |
  4: | | |^| | |*| | | | | |
  3: | | | |*| | | | | | | |
  2: | | | | | | | | | | |*|
  1: -----------------------

==========================================================================
Map id: 5e810457-9460-41e5-a083-e1a8b464526b
An animal has moved from (2,3) to (2,4)
 y\x  0 1 2 3 4 5 6 7 8 910
 11: -----------------------
 10: |*| | | | | | | | | | |
  9: | | | | | | | | | | | |
  8: | | | | | | | | | | |*|
  7: | | | | | |^| | | | | |
  6: | | | | | | | | | | | |
  5: | | | | | | | | | | | |
  4: | | |^| | |*| | | | | |
  3: | | | |*| | | | | | | |
  2: | | | | | | | | | | |*|
  1: -----------------------

==========================================================================
Map id: 5e810457-9460-41e5-a083-e1a8b464526b
An animal has been placed at (5,8)
 y\x  0 1 2 3 4 5 6 7 8 910
 11: -----------------------
 10: |*| | | | | | | | | | |
  9: | | | | | | | | | | | |
  8: | | | | | |^| | | | |*|
  7: | | | | | | | | | | | |
  6: | | | | | | | | | | | |
  5: | | | | | | | | | | | |
  4: | | |^| | |*| | | | | |
  3: | | | |*| | | | | | | |
  2: | | | | | | | | | | |*|
  1: -----------------------

==========================================================================
Map id: 5e810457-9460-41e5-a083-e1a8b464526b
An animal has moved from (5,7) to (5,8)
 y\x  0 1 2 3 4 5 6 7 8 910
 11: -----------------------
 10: |*| | | | | | | | | | |
  9: | | | | | | | | | | | |
  8: | | | | | |^| | | | |*|
  7: | | | | | | | | | | | |
  6: | | | | | | | | | | | |
  5: | | | | | | | | | | | |
  4: | | |^| | |*| | | | | |
  3: | | | |*| | | | | | | |
  2: | | | | | | | | | | |*|
  1: -----------------------

=====================================