=====================================
Map id: 6861bafe-3303-48de-b385-f7c5e8fab3ed
An animal has been placed at (5,6)
 y\x  0 1 2 3 4 5 6 7 8 910
 11: -----------------------
 10: | | |*| |*| | | | | | |
  9: | |*| | | | | | | | | |
  8: | | | | | | | | | | | |
  7: | | |*| | | | | | | | |
  6: | | | | | |^| | | | | |
  5: | | | | | | | | | | | |
  4: |*| | | | | | | | | | |
  3: | | | |*| | | | | | | |
  2: | | |*|*| | | | | | | |
  1: |*| | | | | | | | | |*|
  0: -----------------------

==========================================================================
Map id: 6861bafe-3303-48de-b385-f7c5e8fab3ed
An animal has been placed at (5,7)
 y\x  0 1 2 3 4 5 6 7 8 910
 11: -----------------------
 10: | | |*| |*| | | | | | |
  9: | |*| | | | | | | | | |
  8: | | | | | | | | | | | |
  7: | | |*| | |^| | | | | |
  6: | | | | | | | | | | | |
  5: | | | | | | | | | | | |
  4: |*| | | | | | | | | | |
  3: | | | |*| | | | | | | |
  2: | | |*|*| | | | | | | |
  1: |*| | | | | | | | | |*|
  0: -----------------------

==========================================================================
Map id: 6861bafe-3303-48de-b385-f7c5e8fab3ed
An animal has moved from (5,6) to (5,7)
 y\x  0 1 2 3 4 5 6 7 8 910
 11: -----------------------
 10: | | |*| |*| | | | | | |
  9: | |*| | | | | | | | | |
  8: | | | | | | | | | | | |
  7: | | |*| | |^| | | | | |
  6: | | | | | | | | | | | |
  5: | | | | | | | | | | | |
  4: |*| | | | | | | | | | |
  3: | | | |*| | | | | | | |
  2: | | |*|*| | | | | | | |
  1: |*| | | | | | | | | |*|
  0: -----------------------

==========================================================================
Map id: 6861bafe-3303-48de-b385-f7c5e8fab3ed
An animal has been placed at (5,8)
 y\x  0 1 2 3 4 5 6 7 8 910
 11: -----------------------
 10: | | |*| |*| | | | | | |
  9: | |*| | | | | | | | | |
  8: | | | | | |^| | | | | |
  7: | | |*| | | | | | | | |
  6: | | | | | | | | | | | |
  5: | | | | | | | | | | | |
  4: |*| | | | | | | | | | |
  3: | | | |*| | | | | | | |
  2: | | |*|*| | | | | | | |
  1: |*| | | | | | | | | |*|
  0: -----------------------

==========================================================================
Map id: 6861bafe-3303-48de-b385-f7c5e8fab3ed
An animal has moved from (5,7) to (5,8)
 y\x  0 1 2 3 4 5 6 7 8 910
 11: -----------------------
 10: | | |*| |*| | | | | | |
  9: | |*| | | | | | | | | |
  8: | | | | | |^| | | | | |
  7: | | |*| | | | | | | | |
  6: | | | | | | | | | | | |
  5: | | | | | | | | | | | |
  4: |*| | | | | | | | | | |
  3: | | | |*| | | | | | | |
  2: | | |*|*| | | | | | | |
  1: |*| | | | | | | | | |*|
  0: -----------------------

==========================================================================
Map id: 6861bafe-3303-48de-b385-f7c5e8fab3ed
An animal has been placed at (5,9)
 y\x  0 1 2 3 4 5 6 7 8 910
 11: -----------------------
 10: | | |*| |*| | | | | | |
  9: | |*| | | |^| | | | | |
  8: | | | | | | | | | | | |
  7: | | |*| | | | | | | | |
  6: | | | | | | | | | | | |
  5: | | | | | | | | | | | |
  4: |*| | | | | | | | | | |
  3: | | | |*| | | | | | | |
  2: | | |*|*| | | | | | | |
  1: |*| | | | | | | | | |*|
  0: -----------------------

==========================================================================
Map id: 6861bafe-3303-48de-b385-f7c5e8fab3ed
An animal has moved from (5,8) to (5,9)
 y\x  0 1 2 3 4 5 6 7 8 910
 11: -----------------------
 10: | | |*| |*| | | | | | |
  9: | |*| | | |^| | | | | |
  8: | | | | | | | | | | | |
  7: | | |*| | | | | | | | |
  6: | | | | | | | | | | | |
  5: | | | | | | | | | | | |
  4: |*| | | | | | | | | | |
  3: | | | |*| | | | | | | |
  2: | | |*|*| | | | | | | |
  1: |*| | | | | | | | | |*|
  0: -----------------------

==========================================================================
Map id: 6861bafe-3303-48de-b385-f7c5e8fab3ed
An animal has been placed at (5,10)
 y\x  0 1 2 3 4 5 6 7 8 910
 11: -----------------------
 10: | | |*| |*|^| | | | | |
  9: | |*| | | | | | | | | |
  8: | | | | | | | | | | | |
  7: | | |*| | | | | | | | |
  6: | | | | | | | | | | | |
  5: | | | | | | | | | | | |
  4: |*| | | | | | | | | | |
  3: | | | |*| | | | | | | |
  2: | | |*|*| | | | | | | |
  1: |*| | | | | | | | | |*|
  0: -----------------------

==========================================================================
Map id: 6861bafe-3303-48de-b385-f7c5e8fab3ed
An animal has moved from (5,9) to (5,10)
 y\x  0 1 2 3 4 5 6 7 8 910
 11: -----------------------
 10: | | |*| |*|^| | | | | |
  9: | |*| | | | | | | | | |
  8: | | | | | | | | | | | |
  7: | | |*| | | | | | | | |
  6: | | | | | | | | | | | |
  5: | | | | | | | | | | | |
  4: |*| | | | | | | | | | |
  3: | | | |*| | | | | | | |
  2: | | |*|*| | | | | | | |
  1: |*| | | | | | | | | |*|
  0: -----------------------

=====================================