=====================================
Map id: 6fa9b300-ee8f-4976-a65c-9d969320d500
An animal has been placed at (2,2)
 y\x  2 3 4 5 6 7 8 910
 10: -------------------
  9: | | | | | | | | |*|
  8: | | | | | | | | | |
  7: | | | | |*| | | | |
  6: | | | | | | | | | |
  5: | | | | | | | | |*|
  4: | | | | | | | | | |
  3: | | | | | | | | | |
  2: |^| | | | | | | | |
  1: | | | | |*| | | | |
  0: | | | |*| | | | | |
 -1: -------------------

==========================================================================
Map id: 6fa9b300-ee8f-4976-a65c-9d969320d500
An animal has been placed at (5,6)
 y\x  2 3 4 5 6 7 8 910
 10: -------------------
  9: | | | | | | | | |*|
  8: | | | | | | | | | |
  7: | | | | |*| | | | |
  6: | | | |^| | | | | |
  5: | | | | | | | | |*|
  4: | | | | | | | | | |
  3: | | | | | | | | | |
  2: |^| | | | | | | | |
  1: | | | | |*| | | | |
  0: | | | |*| | | | | |
 -1: -------------------

==========================================================================
Map id: 6fa9b300-ee8f-4976-a65c-9d969320d500
An animal has been placed at (2,3)
 y\x  2 3 4 5 6 7 8 910
 10: -------------------
  9: | | | | | | | | |*|
  8: | | | | | | | | | |
  7: | | | | |*| | | | |
  6: | | | |^| | | | | |
  5: | | | | | | | | |*|
  4: | | | | | | | | | |
  3: |^| | | | | | | | |
  2: | | | | | | | | | |
  1: | | | | |*| | | | |
  0: | | | |*| | | | | |
 -1: -------------------

==========================================================================
Map id: 6fa9b300-ee8f-4976-a65c-9d969320d500
An animal has moved from (2,2) to (2,3)
 y\x  2 3 4 5 6 7 8 910
 10: -------------------
  9: | | | | | | | | |*|
  8: | | | | | | | | | |
  7: | | | | |*| | | | |
  6: | | | |^| | | | | |
  5: | | | | | | | | |*|
  4: | | | | | | | | | |
  3: |^| | | | | | | | |
  2: | | | | | | | | | |
  1: | | | | |*| | | | |
  0: | | | |*| | | | | |
 -1: -------------------

==========================================================================
Map id: 6fa9b300-ee8f-4976-a65c-9d969320d500
An animal has been placed at (5,7)
 y\x  2 3 4 5 6 7 8 910
 10: -------------------
  9: | | | | | | | | |*|
  8: | | | | | | | | | |
  7: | | | |^|*| | | | |
  6: | | | | | | | | | |
  5: | | | | | | | | |*|
  4: | | | | | | | | | |
  3: |^| | | | | | | | |
  2: | | | | | | | | | |
  1: | | | | |*| | | | |
  0: | | | |*| | | | | |
 -1: -------------------

==========================================================================
Map id: 6fa9b300-ee8f-4976-a65c-9d969320d500
An animal has moved from (5,6) to (5,7)
 y\x  2 3 4 5 6 7 8 910
 10: -------------------
  9: | | | | | | | | |*|
  8: | | | | | | | | | |
  7: | | | |^|*| | | | |
  6: | | | | | | | | | |
  5: | | | | | | | | |*|
  4: | | | | | | | | | |
  3: |^| | | | | | | | |
  2: | | | | | | | | | |
  1: | | | | |*| | | | |
  0: | | | |*| | | | | |
 -1: -------------------

==========================================================================
Map id: 6fa9b300-ee8f-4976-a65c-9d969320d500
An animal has been placed at (2,4)
 y\x  2 3 4 5 6 7 8 910
 10: -------------------
  9: | | | | | | | | |*|
  8: | | | | | | | | | |
  7: | | | |^|*| | | | |
  6: | | | | | | | | | |
  5: | | | | | | | | |*|
  4: |^| | | | | | | | |
  3: | | | | | | | | | |
  2: | | | | | | | | | |
  1: | | | | |*| | | | |
  0: | | | |*| | | | | |
 -1: -------------------

==========================================================================
Map id: 6fa9b300-ee8f-4976-a65c-9d969320d500
An animal has moved from (2,3) to (2,4)
 y\x  2 3 4 5 6 7 8 910
 10: -------------------
  9: | | | | | | | | |*|
  8: | | | | | | | | | |
  7: | | | |^|*| | | | |
  6: | | | | | | | | | |
  5: | | | | | | | | |*|
  4: |^| | | | | | | | |
  3: | | | | | | | | | |
  2: | | | | | | | | | |
  1: | | | | |*| | | | |
  0: | | | |*| | | | | |
 -1: -------------------

==========================================================================
Map id: 6fa9b300-ee8f-4976-a65c-9d969320d500
An animal has been placed at (5,8)
 y\x  2 3 4 5 6 7 8 910
 10: -------------------
  9: | | | | | | | | |*|
  8: | | | |^| | | | | |
  7: | | | | |*| | | | |
  6: | | | | | | | | | |
  5: | | | | | | | | |*|
  4: |^| | | | | | | | |
  3: | | | | | | | | | |
  2: | | | | | | | | | |
  1: | | | | |*| | | | |
  0: | | | |*| | | | | |
 -1: -------------------

==========================================================================
Map id: 6fa9b300-ee8f-4976-a65c-9d969320d500
An animal has moved from (5,7) to (5,8)
 y\x  2 3 4 5 6 7 8 910
 10: -------------------
  9: | | | | | | | | |*|
  8: | | | |^| | | | | |
  7: | | | | |*| | | | |
  6: | | | | | | | | | |
  5: | | | | | | | | |*|
  4: |^| | | | | | | | |
  3: | | | | | | | | | |
  2: | | | | | | | | | |
  1: | | | | |*| | | | |
  0: | | | |*| | | | | |
 -1: -------------------

=====================================